AiW
An Interactive Fiction by Alofa Carpenter
Release 1 / Serial number 150902 / Inform 7 build 6L38 (I6/v6.33 lib 6/12N) SD

Basement
You woke up in a dimly lit room... It looks like a basement. How did I get here?

You can see a curtain here.

>open curtain
Looks like I can go through this curtain and into another room!

>enter closet
You can't see any such thing.

* * *

>open curtain
Looks like I can go through this curtain and into another room!

>enter curtain
Closet
There are photos all over the walls... Is that me?

A small wooden chest... Looks pretty old! I wonder what's inside?

You can also see trap door here.

>open chest
You open Wooden chest, revealing Skeleton key and Flashlight.

>take key
A skeleton key (which opens all doors), that's shaped like a skeleton... How fitting.

>take flashlight
Taken.

>unlock trap door
What do you want to unlock trap door with?

>unlock trap door with key
You unlock trap door.

>enter door
(first opening trap door)

Darkness
It is pitch dark, and you can't see a thing.

>turn on flashlight
You switch on the flashlight, it's not too bright but it's better than nothing!

Tunnel
I can't see a thing at the moment.

You can see iron gate here.

* * *

>take flashlight
Taken.

>unlock door with key
You unlock trap door.

>enter door
(first opening trap door)

Darkness
It is pitch dark, and you can't see a thing.

>turn on flashligh
You switch on the flashlight, it's not too bright but it's better than nothing!

Tunnel
I can barely see anything... Smells pretty musty in here.

You can see iron gate here.

>unlock gate with key
You unlock iron gate.

>enter gate
(first opening iron gate)

Operating room
This is not sanitary... There's blood all over the walls.

You can see a doctor here.

>talk to doctor
Try asking about something instead.

>ask doctor
What do you want to ask the doctor for?

>ask doctor what's happening
I didn't understand that sentence.

>ask doctor about room
The doctor attacked and blindfolded me!

Jail cell
Feeling groggy waking up in a new, strange place. Plus, I can't see anything beyond the rusted bars of this cell - it's pitch black out there.

You can see Cell door here.

>open cell dor
I only understood you as far as wanting to open Cell door.

>open door
The door to the jail cell was unlocked... That was almost too easy...

>enter door
Vortex
I got sucked into the vortex, everything is technicolor... Everything is spinning...

You can see Wooden table (on which is Cookie) here.

>x table
The only thing that isn't spinning right now.

On Wooden table is Cookie.

>eat cookie
Everything went dark again.

Hospital room
Groggy again... As I slowly open my eyes I see my mother standing over me. Am I in a hospital bed?

You can see Mother here.

>talk to mother
Try asking about something instead.

>ask mother about room
"Thank God, thank God... Honey do you remember me? Alice? I'm your mother, Alice... You've been in a coma for years...

>ask mother where you are
I didn't understand that sentence.

>ask mother about where you are
"Thank God, thank God... Honey do you remember me? Alice? I'm your mother, Alice... You've been in a coma for years...

>ask mother about what happened
"Thank God, thank God... Honey do you remember me? Alice? I'm your mother, Alice... You've been in a coma for years...

* * *

>open curtain
Looks like I can go through this curtain and into another room!

>go through curtain
Closet
There are photos all over the walls... Is that me?

A small wooden chest... Looks pretty old! I wonder what's inside?

You can also see trap door here.

>open chest
You open Wooden chest, revealing Skeleton key and Flashlight.

* * *

>take flashlight
Taken.

>open trap door
It seems to be locked.

>open trap door with key
You unlock trap door.

>open door
You open trap door.

>x door
You see nothing special about trap door.

>go through trap door
Darkness
It is pitch dark, and you can't see a thing.

>turn on flashlight
You switch on the flashlight, it's not too bright but it's better than nothing!

Tunnel
I can barely see anything... Smells pretty musty in here.

You can see iron gate here.

>open iron gate with key
You unlock iron gate.

>open gate
You open iron gate.

>go through gate
Operating room
This is not sanitary... There's blood all over the walls.

You can see a doctor here.

>x doctor
He's got a strange look in his eyes.

>ask doctor about blood
The doctor attacked and blindfolded me!

Jail cell
Feeling groggy waking up in a new, strange place. Plus, I can't see anything beyond the rusted bars of this cell - it's pitch black out there.

You can see Cell door here.

>open bars with key
You can't see any such thing.

>open door with key
That doesn't seem to be something you can unlock.

>i
You are carrying:
  Flashlight (providing light)
  Skeleton key

>open cell door with key
That doesn't seem to be something you can unlock.

>open flashlight
It isn't something you can open.

>turn on flashlight
That's already on.

>open cell door
The door to the jail cell was unlocked... That was almost too easy...

>go through door
Vortex
I got sucked into the vortex, everything is technicolor... Everything is spinning...

You can see Wooden table (on which is Cookie) here.

>take cookie
Taken.

>eat cookie
Everything went dark again.

Hospital room
Groggy again... As I slowly open my eyes I see my mother standing over me. Am I in a hospital bed?

You can see Mother here.

* * *

>unlock door with key
You unlock trap door.

>go through door
(first opening trap door)

Darkness
It is pitch dark, and you can't see a thing.

>turn on flashlight
You switch on the flashlight, it's not too bright but it's better than nothing!

Tunnel
I can barely see anything... Smells pretty musty in here.

You can see iron gate here.

>open fate
You can't see any such thing.

>unlock gate
What do you want to unlock iron gate with?

>unlock gate with key
You unlock iron gate.

>go through gate
(first opening iron gate)

Operating room
This is not sanitary... There's blood all over the walls.

You can see a doctor here.

>x doctor
He's got a strange look in his eyes.

>ask doctor about what
The doctor attacked and blindfolded me!

Jail cell
Feeling groggy waking up in a new, strange place. Plus, I can't see anything beyond the rusted bars of this cell - it's pitch black out there.

You can see Cell door here.

>open door
The door to the jail cell was unlocked... That was almost too easy...

>go through door
Vortex
I got sucked into the vortex, everything is technicolor... Everything is spinning...

You can see Wooden table (on which is Cookie) here.

* * *

>eat cookie
Everything went dark again.

Hospital room
Groggy again... As I slowly open my eyes I see my mother standing over me. Am I in a hospital bed?

You can see Mother here.

>ask mother about what
"Thank God, thank God... Honey do you remember me? Alice? I'm your mother, Alice... You've been in a coma for years...

* * *

>open curtain
Looks like I can go through this curtain and into another room!

>enter room
You can't see any such thing.

* * *

AiW
An Interactive Fiction by Alofa Carpenter
Release 1 / Serial number 150902 / Inform 7 build 6L38 (I6/v6.33 lib 6/12N) SD

Basement
You woke up in a dimly lit room... It looks like a basement. How did I get here?

You can see a curtain here.

>x curtain
You see nothing special about the curtain.

>open curtain
Looks like I can go through this curtain and into another room!

* * *

>go through curtain
Closet
There are photos all over the walls... Is that me?

A small wooden chest... Looks pretty old! I wonder what's inside?

You can also see trap door here.

>x wooden chest
You can't see any such thing.

>x trap door
You see nothing special about trap door.

>x photos
You can't see any such thing.

>open wooden chest
You can't see any such thing.

>open chest
You open Chest, revealing Skeleton key and Flashlight.

>take key
A skeleton key (which opens all doors), that's shaped like a skeleton... How fitting.

* * *

>take flashlight
Taken.

>open door
It seems to be locked.

>open door with key
You unlock trap door.

>open door
You open trap door.

>go through door
Darkness
It is pitch dark, and you can't see a thing.

>use flashlight
That's not a verb I recognise.

>turn on flashlight
You switch on the flashlight, it's not too bright but it's better than nothing!

Tunnel
I can barely see anything... Smells pretty must in here.

You can see iron gate here.

>x gate
You see nothing special about iron gate.

>open gate
It seems to be locked.

>open gate with key
You unlock iron gate.

>go through gate
(first opening iron gate)

Boiler room
You can see Ladder here.

>x ladder
You see nothing special about Ladder.

>u
(first opening Ladder)

Basement
You woke up in a dimly lit room... It looks like a basement. How did I get here?

You can see a curtain here.

* * *

>open chest
You open Wooden chest, revealing Skeleton key and Flashlight.

>take flashlight
Taken.

>take key
A skeleton key (which opens all doors), that's shaped like a skeleton... How fitting.

>unlock door
What do you want to unlock trap door with?

>unlock door with key
You unlock trap door.

* * *

>turn on flashlight
You switch on the flashlight, it's not too bright but it's better than nothing!

Tunnel
I can barely see anything... Smells pretty musty in here.

You can see iron gate here.

>unlock gate with key
You unlock iron gate.

* * *

>x doctor
He's got a strange look in his eyes.

>talk to doctor
Try asking about what's going on instead.

>what's going on
That's not a verb I recognise.

>ask doctor what's going on
I didn't understand that sentence.

>tell doctor what's going on
I didn't understand that sentence.

>doctor
That's not a verb I recognise.

>x doctor
He's got a strange look in his eyes.

* * *

>what's going on
That's not a verb I recognise.

>ask what's going on
You can't see any such thing.

>ask doctor
What do you want to ask the doctor for?

>what's going on
You can't see any such thing.

>ask doctor about what's going on
The doctor attacked and blindfolded me!

Jail cell
Feeling groggy waking up in a new, strange place. Plus, I can't see anything beyond the rusted bars of this cell - it's pitch black out there.

You can see Cell door here.

>unlock cell door with ke
You can't see any such thing.

>unlock cell door with key
That doesn't seem to be something you can unlock.

>open cell door
The door to the jail cell was unlocked... That was almost too easy...

>go through cell door
Vortex
I got sucked into the vortex, everything is technicolor... Everything is spinning...

You can see Wooden table (on which is Cookie) here.

>x table
The only thing that isn't spinning right now.

On Wooden table is Cookie.

>x cookie
For Alice:

>take cookie
Taken.

* * *

>eat cookie
Everything went dark again.

Hospital room
Groggy again... As I slowly open my eyes I see my mother standing over me. Am I in a hospital bed?

You can see Mother here.

>talk to mother
Try asking about what's going on instead.

>ask mother about what's going on
"Thank God, thank God... Honey do you remember me? Alice? I'm your mother, Alice... You've been in a coma for years...

>ask mother about what
"Thank God, thank God... Honey do you remember me? Alice? I'm your mother, Alice... You've been in a coma for years...

* * *

AiW
An Interactive Fiction by Alofa Carpenter
Release 1 / Serial number 150902 / Inform 7 build 6L38 (I6/v6.33 lib 6/12N) SD

Basement
You woke up in a dimly lit room... It looks like a basement. How did I get here?

You can see a curtain here.

>x doctor
The doctor hit you over the head with a baseball bat! He stole your key and flashlight!

* * *

AiW
An Interactive Fiction by Alofa Carpenter
Release 1 / Serial number 150902 / Inform 7 build 6L38 (I6/v6.33 lib 6/12N) SD

Basement
You woke up in a dimly lit room... It looks like a basement. How did I get here?

You can see a curtain here.

>o curtain
Sorry, that can't be corrected.

>open cutrain
You can't see any such thing.

>open cutain
You can't see any such thing.

>open curtain
Looks like I can go through this curtain and into another room!

* * *

>take flashlight
Taken.

>unlock door
What do you want to unlock trap door with?

* * *

>unlock door with key
You unlock trap door.

>enter trap door
(first opening trap door)

Darkness
It is pitch dark, and you can't see a thing.

>turn on flashlight
You switch on the flashlight, it's not too bright but it's better than nothing!

Tunnel
I can barely see anything... Smells pretty musty in here.

You can see iron gate here.

>enter gate
(first opening iron gate)
It seems to be locked.

>unlock gate
What do you want to unlock iron gate with?

* * *

>unlock gate with key
You unlock iron gate.

>enter gate
(first opening iron gate)

Boiler room
You can see Ladder here.

>go up ladder
I only understood you as far as wanting to go up.

>enter ladder
(first opening Ladder)

Basement
You woke up in a dimly lit room... It looks like a basement. How did I get here?

You can see a curtain here.

* * *

AiW
An Interactive Fiction by Alofa Carpenter
Release 1 / Serial number 150902 / Inform 7 build 6L38 (I6/v6.33 lib 6/12N) SD

Basement
You woke up in a dimly lit room... It looks like a basement. How did I get here?

You can see a curtain here.

>w
(first opening the curtain)

Darkness
It is pitch dark, and you can't see a thing.

>e
You can't go that way.

>n
You can't go that way.

>s
You can't go that way.

>e
You can't go that way.

>w
You can't go that way.

I beg your pardon?

I beg your pardon?

* * *

>w
(first opening the curtain)

Darkness
It is pitch dark, and you can't see a thing.

>d
(first opening trap door)
It seems to be locked.

* * *

AiW
An Interactive Fiction by Alofa Carpenter
Release 1 / Serial number 150902 / Inform 7 build 6L38 (I6/v6.33 lib 6/12N) SD

Basement
You woke up in a dimly lit room... It looks like a basement. How did I get here?

You can see a curtain here.

>enter curtain
(first opening the curtain)
Looks like I can go through this curtain and into another room!

Closet
There are photos all over the walls... Is that me?

A small wooden chest... Looks pretty old! I wonder what's inside?

You can also see trap door here.

>open ches
You can't see any such thing.

>open chest
You open Chest, revealing Skeleton key and Flashlight.

* * *

>take key
A skeleton key (which opens all doors), that's shaped like a skeleton... How fitting.

>unlock trap door with skeleton key
That doesn't seem to fit the lock.

* * *

>enter curtain
(first opening the curtain)
Looks like I can go through this curtain and into another room!

Closet
There are photos all over the walls... Is that me?

A small wooden chest... Looks pretty old! I wonder what's inside?

You can also see trap door here.

>enter trap door
(first opening trap door)
It seems to be locked.

>open chest
You open Chest, revealing Skeleton key.

>take key
Taken.

* * *

>enter curtain
(first opening the curtain)
Looks like I can go through this curtain and into another room!

Closet
There are photos all over the walls... Is that me?

A small wooden chest... Looks pretty old! I wonder what's inside?

You can also see trap door here.

>open chest
You open Wooden chest, revealing Skeleton key and Flashlight.

* * *

>enter gate
(first opening iron gate)

Boiler room
You can see Ladder here.

>go through ladder
(first opening Ladder)
What the heck... I'm back in the basement?!

* * *

AiW
An Interactive Fiction by Alofa Carpenter
Release 1 / Serial number 150902 / Inform 7 build 6L38 (I6/v6.33 lib 6/12N) SD

Basement
You woke up in a dimly lit room... It looks like a basement. How did I get here?

You can see a curtain here.

>enter room
You can't see any such thing.

>enter curtain
(first opening the curtain)

Closet
There are photos all over the walls... Is that me?

A small wooden chest... Looks pretty old! I wonder what's inside?

You can also see trap door here.

>d
(first opening trap door)
It seems to be locked.

>o chest
Sorry, that can't be corrected.

>open chest
You open Chest, revealing Skeleton key and Flashlight.

>take flashlight
Taken.

>take skeleton key
Taken.

>open door
It seems to be locked.

>unlock trap door with skeleton key
That doesn't seem to fit the lock.

>d
(first opening trap door)
It seems to be locked.